12:12
0 53 0 0 18 32 0 0 0 0 0 18
0 0 0 17 18 32 0 0 0 0 18 0
0 96 0 17 17 32 0 0 32 32 0 0
17 0 0 0 0 0 0 0 18 0 0 0
0 0 18 17 17 17 0 18 0 0 0 0
18 0 18 17 17 17 18 0 0 0 32 32
18 32 18 17 17 32 17 0 0 0 32 32
32 32 18 0 18 0 0 17 0 96 0 32
0 0 0 0 0 0 0 0 17 0 0 0
18 17 0 0 17 0 17 0 17 0 0 0
32 17 0 17 17 0 17 0 17 0 0 0
18 18 0 17 18 0 18 87 18 57 0 0
