12:12
18 0 0 18 0 0 32 18 18 0 0
0 0 192 18 0 0 96 0 0 18 0 0
0 0 0 0 17 0 0 0 0 18 32 0
0 96 0 0 17 17 17 18 0 0 0 0
0 0 0 0 17 0 0 17 0 0 0 0
17 17 0 0 18 0 17 0 0 0 0 0
32 18 18 0 0 18 0 38 36 0 0 0
0 38 0 0 0 0 0 0 0 38 0 0
0 0 0 0 18 18 0 0 36 0 0 0
0 32 0 0 32 0 18 0 0 0 34 35
17 0 17 32 0 0 0 0 0 37 0 0
17 17 17 17 0 0 0 0 17 32 0 0
