12:12
0 0 0 0 86 0 0 0 0 0 0 0
17 17 17 0 17 0 17 17 17 17 0 0
0 0 0 0 17 33 17 0 0 17 0 0
32 0 0 0 17 32 17 0 0 34 0 0
0 0 0 0 17 32 17 0 0 17 0 0
33 0 0 96 17 17 17 0 0 17 0 0
0 0 0 0 0 0 0 0 0 17 0 0
0 18 36 18 0 0 0 0 0 17 0 0
0 18 18 18 0 0 0 0 0 17 0 0
0 0 0 0 34 0 0 0 0 17 0 0
32 17 17 17 17 17 17 17 0 0 37 0
32 0 51 0 0 96 0 0 0 0 0 0
