12:12
17 0 0 0 0 0 0 0 0 0 18 18
17 17 18 0 0 0 17 17 0 0 0 32
0 80 18 0 0 32 17 18 18 0 0 0
32 18 18 0 0 37 17 17 0 0 17 17
0 0 0 0 0 96 0 17 17 0 0 0
17 0 0 0 0 0 0 17 17 0 0 32
17 18 18 0 0 0 0 17 17 32 32 34
17 37 32 0 96 0 0 17 17 17 17 17
17 18 18 0 0 0 0 0 0 0 0 0
17 0 0 0 0 32 18 18 0 18 18 18
17 17 0 0 0 18 18 18 0 18 52 0
18 17 49 0 0 0 38 0 0 0 0 0
