12:12
0 57 0 0 0 0 17 0 0 0 0 18   
0 0 0 17 0 0 0 0 0 96 18 17
18 32 18 17 0 17 0 0 0 18 0 17
17 32 32 17 0 17 0 0 32 0 0 17
0 0 18 17 0 32 0 18 0 0 0 17
18 0 18 0 0 0 18 0 0 0 0 32
18 0 18 17 0 32 17 0 0 0 0 32
32 0 18 0 0 17 0 17 0 0 0 32
0 0 0 0 0 18 0 17 17 0 0 17
18 17 0 0 0 17 0 96 0 0 0 17
32 17 0 17 0 17 0 0 0 0 0 17
0 0 0 18 0 17 0 18 0 0 0 60
